T##### T
 #...##
##.#$.##
#.$....#
#!.!#..#
###.@.##
  #.#.#
  #...#
T #####T