T ##### T
  #...#
 ##$#.###
 #...$@.#
 #.#..#.#
 #.#!.!.#
 #...####
T#####  T