T##### T
 #...##
##!#$.##
#.$....#
#!.!#$.#
###.@.##
  #.#.#
  #...#
T #####T