T   ####
#####..#
#...*..#
#.*!#..#
##.##.##T
#.$....#
#.@#...#
#..#####
####T