T #####T
###...#
#.$.#.##
#.#..!.#
#.!..#.#
##$#!$.#
 #@..###
T##### T
