T   ####
#####..#
#...$..#
#.*!#..#
##.##.##T
#......#
#.@#...#
#..#####
####T