T #####T
###...#
#.$.#.##
#.#..!.#
#....#.#
##$#!..#
 #@..###
T##### T
