T ####  T
 ##..###
##..!..#
#.$!$!$##
#.!$!$!.#
##$.#!$.#
 #..@..##
T#######T